0010000000
0100000000
0000000000
0000000000
0000000000
1000000000
0010010000
0000100000
0000000000
0001000000
